OOOOOOOOOOOOOOOO
O##############O
O####..E...E..#O
O####.#.###.#.#O
O#.E.E#...#..##O
O#P##..#.###.##O
O#.#########.##O
O#FFF...#F....#O
O######.#####.#O
O###..E......I#O
O##############O
OOOOOOOOOOOOOOOO