OOOOOOOOOOOOOOOOOOOOOO
O####################O
O####..E....P....E..#O
O####.#.#####.###.#.#O
O#.E.E#...####..#..##O
O#.##########.#.##.##O
O###.##...#...#######O
O###.#..#.#.##F..####O
O#.#...##.#....#...##O
O#.##..#..#.##.###.##O
O#.######.##..####.##O
O#FFF...#.#.##.F....#O
O######.##....#####.#O
O#...##.#.#.##.####F#O
O###..E...#........I#O
O####################O
OOOOOOOOOOOOOOOOOOOOOO